¨€¨€¨€¨€¨€¨€¨€¨€¨€¨€¨€¨€¨€¨€¨€¨€¨€¨€¨€¨€¨€
¡ð¡ð¨€      ¨€              ¨€          ¨€
¨€¡ð¨€  ¨€¨€¨€  ¨€  ¨€¨€¨€  ¨€¨€¨€  ¨€  ¨€
¨€¡ð¨€  ¨€      ¨€      ¨€      ¨€  ¨€  ¨€
¨€¡ð¨€  ¨€  ¨€¨€¨€¨€¨€  ¨€¨€¨€  ¨€  ¨€  ¨€
¨€¡ð¨€              ¨€  ¨€      ¨€  ¨€  ¨€
¨€¡ð¨€  ¨€¨€¨€¨€¨€¨€¨€  ¨€  ¨€¨€¨€¨€¨€  ¨€
¨€¡ð¨€  ¨€¡ð¡ð¡ð¡ð¡ð¨€  ¨€              ¨€
¨€¡ð¨€¨€¨€¡ð¨€¨€¨€¡ð¨€  ¨€¨€¨€  ¨€¨€¨€¨€¨€
¨€¡ð¡ð¡ð¨€¡ð¨€¡ð¡ð¡ð¨€  ¨€      ¨€      ¨€
¨€¨€¨€¡ð¨€¡ð¨€¡ð¨€¨€¨€  ¨€¨€¨€¨€¨€  ¨€  ¨€
¨€  ¨€¡ð¡ð¡ð¨€¡ð¨€          ¨€      ¨€  ¨€
¨€  ¨€¨€¨€¨€¨€¡ð¨€  ¨€¨€¨€  ¨€  ¨€¨€¨€  ¨€
¨€          ¨€¡ð¨€      ¨€  ¨€      ¨€  ¨€
¨€  ¨€¨€¨€¨€¨€¡ð¨€¨€¨€¨€¨€  ¨€  ¨€¨€¨€  ¨€
¨€          ¨€¡ð¡ð¡ð¡ð¡ð¨€  ¨€  ¨€      ¨€
¨€  ¨€¨€¨€  ¨€¨€¨€¨€¨€¡ð¨€  ¨€  ¨€  ¨€¨€¨€
¨€      ¨€          ¨€¡ð¨€      ¨€      ¨€
¨€¨€¨€  ¨€¨€¨€  ¨€¨€¨€¡ð¨€¨€¨€¨€¨€¨€¨€  ¨€
¨€          ¨€        ¡ð¡ð¡ð¡ð¡ð¡ð¡ð¡ð¡ð¡ð
¨€¨€¨€¨€¨€¨€¨€¨€¨€¨€¨€¨€¨€¨€¨€¨€¨€¨€¨€¨€¨€
