¨€¨€¨€¨€¨€¨€¨€¨€¨€¨€¨€¨€¨€¨€¨€¨€¨€¨€¨€¨€¨€
¨€  ¨€                              ¨€  ¨€
¨€  ¨€¨€¨€  ¨€¨€¨€¨€¨€¨€¨€¨€¨€  ¨€  ¨€  ¨€
¨€      ¨€  ¨€          ¨€      ¨€  ¨€  ¨€
¨€¨€¨€  ¨€  ¨€¨€¨€  ¨€  ¨€  ¨€¨€¨€  ¨€  ¨€
¨€  ¨€  ¨€          ¨€  ¨€  ¨€      ¨€  ¨€
¨€  ¨€  ¨€¨€¨€¨€¨€¨€¨€¨€¨€  ¨€  ¨€¨€¨€  ¨€
¨€  ¨€  ¨€          ¨€      ¨€      ¨€  ¨€
¨€  ¨€  ¨€  ¨€¨€¨€  ¨€  ¨€¨€¨€¨€¨€  ¨€  ¨€
¨€      ¨€  ¨€          ¨€      ¨€  ¨€  ¨€
¨€  ¨€¨€¨€  ¨€¨€¨€¨€¨€¨€¨€¨€¨€  ¨€  ¨€  ¨€
¨€  ¨€          ¨€              ¨€  ¨€  ¨€
¨€  ¨€¨€¨€¨€¨€  ¨€  ¨€¨€¨€  ¨€¨€¨€  ¨€  ¨€
¨€  ¨€      ¨€  ¨€  ¨€      ¨€      ¨€  ¨€
¨€  ¨€  ¨€  ¨€  ¨€¨€¨€  ¨€¨€¨€  ¨€¨€¨€  ¨€
¨€      ¨€  ¨€      ¨€      ¨€  ¨€      ¨€
¨€¨€¨€¨€¨€  ¨€¨€¨€  ¨€  ¨€  ¨€  ¨€  ¨€  ¨€
¨€      ¨€      ¨€  ¨€  ¨€  ¨€  ¨€  ¨€  ¨€
¨€  ¨€  ¨€¨€¨€  ¨€  ¨€  ¨€  ¨€  ¨€¨€¨€  ¨€
¨€  ¨€              ¨€  ¨€              ¨€
¨€¨€¨€¨€¨€¨€¨€¨€¨€¨€¨€¨€¨€¨€¨€¨€¨€¨€¨€¨€¨€
