¨€¨€¨€¨€¨€¨€¨€¨€¨€¨€¨€¨€¨€¨€¨€¨€¨€¨€¨€¨€¨€
¨€  ¨€                          ¨€      ¨€
¨€  ¨€¨€¨€  ¨€¨€¨€¨€¨€  ¨€¨€¨€  ¨€  ¨€¨€¨€
¨€      ¨€  ¨€      ¨€  ¨€      ¨€      ¨€
¨€¨€¨€  ¨€  ¨€¨€¨€  ¨€  ¨€  ¨€¨€¨€¨€¨€  ¨€
¨€      ¨€          ¨€  ¨€  ¨€          ¨€
¨€  ¨€¨€¨€¨€¨€  ¨€¨€¨€  ¨€  ¨€¨€¨€  ¨€  ¨€
¨€  ¨€          ¨€      ¨€      ¨€  ¨€  ¨€
¨€  ¨€¨€¨€¨€¨€  ¨€  ¨€¨€¨€¨€¨€  ¨€  ¨€¨€¨€
¨€          ¨€  ¨€  ¨€  ¨€      ¨€      ¨€
¨€¨€¨€¨€¨€  ¨€¨€¨€  ¨€  ¨€  ¨€¨€¨€¨€¨€  ¨€
¨€      ¨€  ¨€      ¨€      ¨€          ¨€
¨€  ¨€¨€¨€  ¨€  ¨€¨€¨€  ¨€¨€¨€  ¨€¨€¨€  ¨€
¨€  ¨€      ¨€  ¨€      ¨€      ¨€      ¨€
¨€  ¨€  ¨€¨€¨€  ¨€¨€¨€  ¨€  ¨€¨€¨€  ¨€¨€¨€
¨€  ¨€      ¨€      ¨€  ¨€  ¨€  ¨€      ¨€
¨€  ¨€¨€¨€  ¨€¨€¨€  ¨€  ¨€  ¨€  ¨€¨€¨€  ¨€
¨€      ¨€  ¨€      ¨€      ¨€          ¨€
¨€  ¨€¨€¨€  ¨€  ¨€¨€¨€¨€¨€¨€¨€  ¨€¨€¨€¨€¨€
¨€              ¨€                      ¨€
¨€¨€¨€¨€¨€¨€¨€¨€¨€¨€¨€¨€¨€¨€¨€¨€¨€¨€¨€¨€¨€
