¨€¨€¨€¨€¨€¨€¨€¨€¨€¨€¨€¨€¨€¨€¨€¨€¨€¨€¨€¨€¨€
¨€      ¨€                      ¨€      ¨€
¨€¨€¨€  ¨€¨€¨€¨€¨€  ¨€  ¨€¨€¨€  ¨€  ¨€¨€¨€
¨€      ¨€      ¨€  ¨€  ¨€      ¨€      ¨€
¨€  ¨€¨€¨€  ¨€  ¨€¨€¨€  ¨€  ¨€¨€¨€¨€¨€  ¨€
¨€          ¨€          ¨€              ¨€
¨€¨€¨€¨€¨€¨€¨€¨€¨€¨€¨€¨€¨€¨€¨€¨€¨€¨€¨€  ¨€
¨€                  ¨€      ¨€          ¨€
¨€¨€¨€  ¨€¨€¨€¨€¨€¨€¨€  ¨€  ¨€  ¨€¨€¨€¨€¨€
¨€      ¨€          ¨€  ¨€      ¨€      ¨€
¨€  ¨€¨€¨€  ¨€¨€¨€  ¨€  ¨€¨€¨€¨€¨€¨€¨€  ¨€
¨€  ¨€      ¨€      ¨€              ¨€  ¨€
¨€  ¨€  ¨€¨€¨€  ¨€¨€¨€¨€¨€¨€¨€¨€¨€  ¨€  ¨€
¨€  ¨€      ¨€              ¨€  ¨€  ¨€  ¨€
¨€  ¨€¨€¨€  ¨€¨€¨€¨€¨€  ¨€  ¨€  ¨€  ¨€  ¨€
¨€      ¨€  ¨€          ¨€      ¨€      ¨€
¨€  ¨€  ¨€  ¨€  ¨€¨€¨€  ¨€¨€¨€¨€¨€¨€¨€  ¨€
¨€  ¨€  ¨€  ¨€      ¨€  ¨€          ¨€  ¨€
¨€  ¨€¨€¨€  ¨€¨€¨€  ¨€¨€¨€  ¨€  ¨€¨€¨€  ¨€
¨€              ¨€          ¨€          ¨€
¨€¨€¨€¨€¨€¨€¨€¨€¨€¨€¨€¨€¨€¨€¨€¨€¨€¨€¨€¨€¨€
